  M  P      V   P   E V
     P M        P  P   
     P     P M  P  PPPP
     P     P    P     M
     P     P    P M    
     P     P    P      
     P     P    P      
     P     P    P      
J    P     P    P      
     P   M P    P  V   
     P     P  M P      
           P    P M    
           P    P      
   M    V  P    P      
           PM          
           P            