P                      E
 P                    P 
  P                  P  
   P                P   
    P              P    
     P            P     
      P          P      
       P   M M  P       
        P      P        
         P    P         
          P MP        MM
           PP           
           PP           
          P  P          
         P    P         
J       P      P      M 