                       
        M   V         J
     PPPPPPPPPPPPPPPPPPP
    P      V           
    P    PPPPPPPPPP    
    P    P        P    
    P    P        P   M
 M  P    P    P   P    
    P    P  E P   P    
    P    PPPPPP   P    
    P             P    
    P             P    
    P       M     P    
V   PPPPPPPPPPPPPPP    
                       
             M          